#####################################################################################
#...###.....................#####...................................................#
#...###.....................######..................................................#
#...............#............######.................................................#
#.............................######................................................#
#................................###................................................#
#...................................................................................#
#...................................................................................#
#.....#..............................................###........##..................#
#...####......##.........###............###...........#........########.............#
#########....####........####...........###.....................########............#
#########....####.........###..........###.......................#########..........#
#....###......##...........##..........##..........................#######..........#
#.....................................##..............................####..........#
#....................................###................................#...........#
#............................#......####...........######...........................#
#....................................###.........#######............................#
#................................................#######............................#
#....................###..........................#####.............................#
#...##.............#####............................##.........................####.#
#..####.............###.......................................................#####.#
#.#####..............................####.....................................#####.#
#######...........................######...................####...............####..#
#######.........................########.................#######....................#
#######.........................#######..................########...................#
#######...........................####...................########...................#
#.#####............................###......................#####...................#
#.#####.............................................................................#
#..####.............................................................................#
#..####................................#........#####.....................#........##
#..##...................................#.....########....................##......###
#..............................................######.....................#........##
#...............................................####................................#
#...................................................................................#
#............##.......................##............................................#
#...........###......................####...........................................#
#...........###.........#######......###................####........................#
#.......................########.......................######.......................#
#.......................#######.......................#######.......................#
#.........................#####......................#######........................#
#..........................####.......................##............................#
#...........................####...............................................#....#
#...........................####...............................................###..#
#............................##........#####.......................####.......#####.#
#.....................................#######....................######......######.#
#......................................######...................#######......######.#
#......................................####...................####.###.......######.#
#............##...............................................##..............####..#
#...........###................................................................####.#
#........######................................................................####.#
##############..................................##..............................#####
##############..................................#...............................#####
#############.......##........................###.................................###
#.#####..##........####......................####...................................#
#..#...............#####....................#####.......................##..........#
#...................####....................#####......................##...........#
#....................###....................######....................###...........#
#............................................#####....................###...........#
#.............................................###.......................#...........#
#..............................................##...................................#
#..............................................##...................................#
#.............................................###...................................#
#...................##......####.............####...................................#
#..................###......####.............###.........#..........###.............#
#.................####..................................####......#####.............#
#................####...................................#####.....#####.............#
#................###.....................................###.......####........#....#
#.............................................................................####..#
#####################################################################################
