############################################################
#.............###................................####......#
#..............###...............................###.......#
#..............###................................#........#
#...............###........................................#
#.......##......##...................###...................#
#.......###..........................####..................#
#.......###..........................####..................#
#.......###..........................####..................#
#.......##...................##.......###.............#....#
#............................###.......##........##..###...#
#.............................##.................######....#
#..............................#.................######....#
#...#...............#..........#..................##.......#
#..#................##..........#................##........#
#.##...............####.........##...............#.........#
####.........#.....######..................................#
###..........#.....#######.................................#
###..........#.....#######.................................#
##..................######.................................#
#...................##.................#...................#
#...................#..................#...............##..#
#.....................................#................###.#
#..............................#...............###......##.#
#............###...#..........................####.........#
#............######.........................######.........#
#............#####.........................#####...........#
#............####..........................####............#
#.............##...........................###.............#
#..........................................................#
#...........................#....###................##.....#
#...........................##..#####...............####...#
#............................########................###...#
#.......###...................#######.................##...#
#.......###....................###.........................#
#.......###................................................#
#.......##.................................................#
#......................##...............####...............#
#......................###..............####...............#
#......................####.............####...............#
#.......................####............###................#
#........................###...............................#
#........................####..............................#
#.........................###..............................#
#.........................##...........................#...#
#.....................................................###..#
#..................###................................####.#
#..................####...............................####.#
#..................####................................###.#
#...................##.................................###.#
#....................#.................................###.#
#..........###.........................................#####
#.........####.........................................#####
#..........###.......##................................###.#
#...........##......###....................................#
#...................###....................................#
#...................##.......................#.............#
#..................##.......................##.............#
#......#...........##................#########.............#
#......##.........###.................#####................#
#......###.......####...........#......###.................#
#.......###......##.............##......#..................#
#.......###.....................##.........................#
#.......###....................####........................#
#......####....................####....................##..#
#......####...........#.......#####...................######
#......####...........#......######.....#.............######
#......####.........###......#####......##............######
#......#####........###......#####.......#............######
#.......###........####................................#####
############################################################
