##############################################################################
#........................#####...............................................#
#.....................#######..........###.........###############...........#
#.......##..........########.........####.........#################..........#
#......###..........#######.......######..........##################.........#
#......................##........#####...........########.....######.........#
#................................####...........................###..........#
#................................####........................................#
#................................####........................................#
#...............................####.........................................#
#...............................####.........................................#
#.........###....................##..........................................#
#.........###................................................................#
#..........###...................................................###.........#
#...........##..................................................####.........#
#....................##........................................#####.........#
#....................####..................................###...............#
#.....................######................................#................#
#.......................######...............................................#
#.........................###....................##..........................#
#...............................................####.........................#
#...............................................#####.....##.................#
#.....##.........................................#........###..........##...##
#......######............................####.............#####...........####
#.......#####...........................#####..............##########......###
#.........###...........................#####...................####.........#
#.........####...........................####.....................#..........#
#..........###...........................####................................#
#..........###.................##.........####.......####....................#
#..........##................####..........####.....#####....................#
#.........##..............#######...........####...######....................#
#.........##.............######.....................####.....................#
#........................#####..........................................##...#
#........................####...........................................###..#
#...........####..........##............................................######
#...........######...........................................###..........####
#...........######..........................................###............###
#............#####.........................................##...............##
#........................................##...............###................#
#........................................####............###.................#
#........................................####...........####.................#
#...............................###......#####........######........###......#
#..............................####.......####........######.......#####.....#
#.............................######...................####.........####.....#
#...............................####....................#.............##.....#
#................................####........................................#
#.................................###........................................#
#......#............................##......##...............................#
#.....#######........###..................#####.............................##
#.....########.......#####..............#######............................###
#.......#####..........####.............#######............................###
#.........#..............###............#####................................#
#.........................###............###....................###..........#
#.........................####............#....................#####.........#
#..........................###................................#######........#
#...........................###..............................########........#
#............................#...............................#######.........#
#..###........................................................######.........#
#..###..........................................................####.........#
#.###............................................................###.........#
#.##.........##...................................................##.........#
#.#..........###............###.....................###......................#
#............###...........#####.....................####....................#
#...........####..........######......................######.................#
#...........##............###............##.............#####................#
##############################################################################
