#################################################################################
#..#...............####....................##.....................#####.........#
#.................######..........................................#######.......#
#.................#######.........................................#########.....#
#...................######.........................................#########....#
#....................#####.........................................#########....#
#.....................###...........................................#######.....#
#...................................................................###.........#
#...........##......................................................#...........#
#..........####....................................................##...........#
#.........#####...................................................##............#
#........#######.........................................#####..####............#
#........#########...........................#...........##########.............#
#........#########.......................................#########..............#
#.........#########.......................................#######..........###..#
#..........#................#...............##............######..........####..#
#..........................##..............###............#####...........####..#
#..........................................####...........#####...........#####.#
#.........................................#####...........####............#####.#
#.........................................####.............###.............####.#
#..........................................................###.............######
#..........................................................................######
#...................##..............#......................................####.#
#..................####............###.....................................####.#
#...##............#####...........####..............##.....................####.#
#..###............#####...........#####............####...................#####.#
#.#####...........####............#####...........#####...................#####.#
#######...........####.............####..........######..................######.#
#######............##...............###........#######..................#######.#
#######.......................................#######..................##########
######........................................#######..................##########
######.........................................#####..................###...#####
######.....................##...................................................#
#...##....................####.............................##...................#
#...##....................#####...........................####..................#
#....##...................#####...........................#####.................#
#...####...................######.........................#####.................#
#...#####...................######..............................................#
#...#####...................#######.............................................#
#...#####....................######.............................................#
#...####......................###...............................................#
#............................................................................#..#
#...................##......................................................#...#
#..................####....................................................#....#
#.................######..................................................##....#
#.................######.................................###....................#
#..................#####.................................###....................#
#...................####..................................##....................#
#.....................##............##....................##....................#
#...........##.....................####....................#....................#
#..........####...................#####....................##...................#
#.........#####...................#####...................####......##..........#
#.........#####..................######....................###......###.........#
#.........#####.................#######.........###........###......###.........#
#..........####................########.........###.................###.........#
#...........###................########.........###..................#..........#
#...........###................#######...........##.............................#
#...........###..................#####..........................................#
#...........##.....................###..........................................#
#..........####.....................###.........................................#
#.........#####.....................###...................#####.................#
#........######......................#............################..............#
#......#########..................................#################.............#
#......##..#####.................................##################.............#
#............###...........##....................#################..............#
#..............#..........#####..................################...............#
#.........................#####...................#####.........................#
#.........................#####....................##.......................##..#
#..........................###.............................................####.#
#..........................###............................................#####.#
##.........................###........##..................................#######
##.........................###........###..................................######
##.........................###........####..................................###.#
##..................###....###.........###..................................###.#
#..................####.....##..............................................###.#
#.................####......................................................##..#
#.................####.....................................................####.#
#..................##.....................................................#####.#
#................................................##.....................#######.#
#................................................##....................##########
#................................................##....................##########
#...................................#...................................#########
#.................................#####.....................##...........########
#.................................#####....................####...........####..#
#################################################################################
