#############################################################
#.............####..........................................#
#.............#####..###....####................##..........#
#.............##########....####..............###...........#
#..............########.....###...............##............#
#....................##.......................#.............#
#.....................#.....................................#
#............................................#..............#
#....#..................................######..............#
#...##...............#..................######..............#
#....#..............###................######...............#
#...................###...............#.....................#
#...................###.....................................#
#....................##......#..............................#
#....................###....###.............................#
#...................###.....###..........................##.#
#...................###.....##...........................##.#
#.###...............###.................................###.#
#.###...............###.................................###.#
#.###................##...................######........###.#
#....................###.................#######............#
#...................####.................#####....#.........#
#...................####.................###......##........#
#...................###...........................##........#
#...................###...........................###.......#
#.................................................#####.....#
#........#####....................##..............######....#
#........###.....................##...............#######...#
#.........#.....................###...............######....#
#...............................###...............#.........#
#................................##.........................#
#......................#.........###........................#
#......................###.......####.............#.........#
#..##.....#............#####.....#####............###.......#
#.####....#..............####......##............####.......#
#.###.....................###.....................###.......#
#.##..............................................###.......#
#..................................................#........#
#.........................................##................#
#...............##.......................##.................#
#..##.........####..........................................#
#..#..........###...........................................#
#.##..........###...........................................#
#.#...........#...................##.............#........###
#.................................##............##.......####
#.................................##...........###.......####
#................................##......................##.#
#...............................###.....................###.#
#....................##.........###....................####.#
#..............................####...................#####.#
#..............................###...................#####..#
#####..........................##............##......####...#
#.###.......................................###.............#
#...........................................###.............#
#...........................................##..............#
#...........................................##..............#
#...........................................###.............#
#.###.......................................###.............#
#.###.......................................###.............#
#############################################################
