###########################################################
#..................####...................##............###
#..................####.................................###
#..................####....................#..............#
####.......###.....###..............##...########.........#
###.......####....................##############..........#
#...................##....................................#
########..........#####...................................#
########..........#####..............................###..#
#..................####................................##.#
#.........####.................................##.........#
#.........###................................#####........#
#........................##...............................#
#.......................#########.......................###
#####...................##########.....................####
#.###.................................................##..#
#.........................................................#
#...................#.....................................#
#..................####....................#..............#
####.........#....#####...................####............#
##............#########....................#..............#
#.............#............................##.............#
#.....##..................................####.....####...#
#......##......................###....###.........###.....#
#.......##.....................#..........................#
#.......######...............................#####........#
#........#######.....................###...########.......#
#.............##..........................................#
#.....###......##.........................................#
#.....####....##..........................................#
###########################################################
